1111111111111
10010000000C1
1000011111001
1P0011E000001
1000010010011
1011110110111
1000000000001
1111111111111
